%%%%%%%%%%%%%%%%%
% P.% .         %
%. .%%%%%       %
%               %
%%%%%%%%%%%%%%%%%%